11111111111111111111111111111111111111
1000001000000000000000000N000000000C01
10E00000000001111111011111111111111101
111111100011111111C0011110001111111101
100000001111111PC00001010C001111111101
1000000000000C000000010000001111111C01
1001111111C000000000000001111111100001
10111111C00000000000000111111100000001
101111CCCCCCC0CCCCCC011111110000000001
10111111111111111111011111110000011101
10111111111111111111011111110001111101
10111111111111111111011111110111111101
100C0000000001111111000000000000000001
10000000000C011111110110000C0000000001
10000000000C01111111011111111111110001
10000000000C000000000000000C0000000001
11111111111111111111111111111111111111