11111111111111111111111111
1001C0P0000000C0000001C001
1C0000110111011101110000C1
10000001000100010001000001
10000001C11101110001000001
10000001000100010001000001
100000010111011100010C0001
10C0C00000C0000000C00000E1
11111111111111111111111111